1111111111111111
100P000000000X01
1000111111100001
1C00100000100C01
1000100000100001
1C00100000100C01
1000111111100001
10000X000000E001
1111111111111111