1111111111111111
1P00000000000001
1000111111100001
1C00100000100C01
1000100XX0100001
1C00100000100C01
1000111111100001
100000000000E001
1111111111111111